1111111111111
10E10EEEEEEC1
1EE0011111001
1P0011E0000E1
1111111111111