111111111111111111
1E0CP0111111111111
111111111111111111