1111111111111
10E10000000C1
1E00011111001
1P0011E0000E1
1111111111111