1111111111
1P0000C001
1000000001
100EECCC01
1000000001
1111111111