1111111111111111111111111111111111
1E00000000000000000000000000000101
11100101010000001010010000011111C1
1010010010101010001001000000010001
1P00000000000000000000000000000111
1111111111111111111111111111111111