1111111111
1P0E000C01
1000000001
1000000001
1111111111
1111111111