1111111111
10000PC001
1000000001
100EECCC01
1000000001
1111111111